alleyway	acl:relcl	1
speculation	acl	1
month	acl:relcl	1
begin	acl	1
cloth	acl:relcl	1
reassurance	acl	1
road	acl:relcl	1
warning	acl	1
clause	acl:relcl	1
public	acl:relcl	1
chick	acl:relcl	1
beard	acl:relcl	1
tradition	acl	1
memory	acl:relcl	1
joke	acl:relcl	1
mirth	acl:relcl	1
ruling	acl:relcl	1
hotel	acl:relcl	1
joystick	acl:relcl	1
field	acl	1
possibility	acl	1
policy	acl:relcl	1
charge	acl:relcl	1
bomb	acl	1
resource	acl:relcl	1
help	acl:relcl	1
presence	acl:relcl	1
crash	acl:relcl	1
seriousness	acl	1
circle	acl	1
substance	acl:relcl	1
owner	acl:relcl	1
chase	acl:relcl	1
set	acl:relcl	1
criterion	acl:relcl	1
accusation	acl	1
happiness	acl	1
signal	acl:relcl	1
call	acl	1
constitution	acl:relcl	1
chunk	acl:relcl	1
knowledge	acl:relcl	1
geometry	acl:relcl	1
news	acl:relcl	1
drink	acl:relcl	1
family	acl:relcl	1
condition	acl:relcl	1
atmosphere	acl:relcl	1
wheel	acl:relcl	1
siege	acl:relcl	1
regulation	acl:relcl	1
order	acl:relcl	1
collage	acl:relcl	1
presumption	acl:relcl	1
cascade	acl:relcl	1
content	acl:relcl	1
hospital	acl:relcl	1
bank	acl:relcl	1
crate	acl:relcl	1
dress	acl:relcl	1
pinky	acl:relcl	1
taco	acl:relcl	1
expectation	acl	1
participant	acl:relcl	1
bankruptcy	acl:relcl	1
graphic	acl:relcl	1
flow	acl:relcl	1
body	acl:relcl	1
sense	acl	1
minimum	acl:relcl	1
b&b	acl:relcl	1
intelligence	acl:relcl	1
schtick	acl:relcl	1
sobriety	acl:relcl	1
will	acl:relcl	1
function	acl:relcl	1
sunglasses	acl:relcl	1
seed	acl:relcl	1
look	acl:relcl	1
declaration	acl	1
likelihood	acl	1
reaction	acl:relcl	1
board	acl:relcl	1
deal	acl:relcl	1
gene	acl:relcl	1
chemical	acl:relcl	1
challenge	acl:relcl	1
moisture	acl:relcl	1
wiki	acl:relcl	1
banner	acl:relcl	1
bar	acl	1
answer	acl:relcl	1
processor	acl:relcl	1
law	acl:relcl	1
alias	acl:relcl	1
tourist	acl:relcl	1
ship	acl:relcl	1
call	acl:relcl	1
trouble	acl:relcl	1
inspector	acl:relcl	1
software	acl:relcl	1
capsule	acl:relcl	1
lightness	acl:relcl	1
degree	acl:relcl	1
killer	acl:relcl	1
attachment	acl:relcl	1
risk	acl	1
thing	acl	1
registration	acl:relcl	1
guidance	acl:relcl	1
pain	acl:relcl	1
quest	acl:relcl	1
icicle	acl:relcl	1
misery	acl:relcl	1
blow	acl:relcl	1
mind	acl:relcl	1
specification	acl:relcl	1
plant	acl:relcl	1
banquet	acl:relcl	1
ceasefire	acl:relcl	1
sort	acl:relcl	1
dog	acl:relcl	1
access	acl:relcl	1
tattoo	acl:relcl	1
innovation	acl:relcl	1
member	acl:relcl	1
manoeuvre	acl:relcl	1
bequest	acl:relcl	1
decision	acl:relcl	1
threat	acl	1
opportunity	acl:relcl	1
sector	acl:relcl	1
premonition	acl	1
headwind	acl:relcl	1
future	acl:relcl	1
metal	acl:relcl	1
cycle	acl:relcl	1
right	acl:relcl	1
combo	acl:relcl	1
predisposition	acl	1
platform	acl:relcl	1
persistency	acl:relcl	1
retailer	acl:relcl	1
scrap	acl:relcl	1
photographer	acl:relcl	1
plunge	acl:relcl	1
reason	acl	1
honey	acl:relcl	1
kb	acl:relcl	1
education	acl:relcl	1
type	acl:relcl	1
superstition	acl:relcl	1
reverence	acl:relcl	1
concept	acl:relcl	1
message	acl:relcl	1
memo	acl:relcl	1
happiness	acl:relcl	1
sense	acl:relcl	1
bubble	acl:relcl	1
port	acl:relcl	1
neologism	acl:relcl	1
suspicion	acl	1
character	acl:relcl	1
garment	acl:relcl	1
chocolate	acl:relcl	1
up	acl:relcl	1
reminder	acl:relcl	1
plane	acl:relcl	1
cashout	acl:relcl	1
paper	acl:relcl	1
text	acl:relcl	1
movement	acl:relcl	1
contract	acl:relcl	1
relative	acl:relcl	1
statement	acl	1
state	acl:relcl	1
condition	acl	1
cafe	acl:relcl	1
tank	acl:relcl	1
stubbornness	acl:relcl	1
twist	acl	1
favor	acl:relcl	1
situation	acl:relcl	1
saying	acl:relcl	1
think	acl:relcl	1
fantasy	acl:relcl	1
promise	acl	1
grounds	acl	1
report	acl	1
appy	acl:relcl	1
junkie	acl:relcl	1
generation	acl:relcl	1
curse	acl:relcl	1
ripple	acl:relcl	1
mechanic	acl:relcl	1
feeling	acl:relcl	1
attention	acl:relcl	1
warning	acl:relcl	1
expression	acl:relcl	1
sliver	acl:relcl	1
datum	acl:relcl	1
option	acl	1
employee	acl:relcl	1
devil	acl:relcl	1
spot	acl:relcl	1
ray	acl:relcl	1
luxury	acl:relcl	1
information	acl:relcl	1
tag	acl:relcl	1
park	acl	1
assistance	acl:relcl	1
faction	acl:relcl	1
row	acl:relcl	1
tradition	acl:relcl	1
chromatograph	acl:relcl	1
object	acl:relcl	1
everything	acl:relcl	1
article	acl:relcl	1
store	acl:relcl	1
recklessness	acl:relcl	1
practice	acl:relcl	1
treat	acl:relcl	1
female	acl:relcl	1
programme	acl:relcl	1
fight	acl:relcl	1
risk	acl:relcl	1
assumption	acl	1
norm	acl:relcl	1
deficiency	acl:relcl	1
channel	acl:relcl	1
armament	acl:relcl	1
hour	acl:relcl	1
affair	acl:relcl	1
nick	acl:relcl	1
series	acl:relcl	1
guideline	acl:relcl	1
asset	acl:relcl	1
slice	acl:relcl	1
counterfeiting	acl:relcl	1
specie	acl:relcl	1
minute	acl:relcl	1
route	acl:relcl	1
stare	acl:relcl	1
navy	acl:relcl	1
legend	acl	1
operation	acl:relcl	1
beating	acl:relcl	1
thought	acl:relcl	1
clinic	acl:relcl	1
hell	acl	1
eye	acl:relcl	1
predator	acl:relcl	1
hose	acl:relcl	1
crisis	acl:relcl	1
pyramid	acl:relcl	1
mold	acl:relcl	1
halo	acl:relcl	1
compromise	acl:relcl	1
end	acl	1
evidence	acl:relcl	1
difficulty	acl:relcl	1
energy	acl:relcl	1
tragedy	acl:relcl	1
schedule	acl:relcl	1
moment	acl:relcl	1
money	acl:relcl	1
virus	acl:relcl	1
door	acl	1
address	acl:relcl	1
waiter	acl:relcl	1
habitat	acl:relcl	1
shrub	acl:relcl	1
extent	acl	1
loan	acl:relcl	1
case	acl	1
intensity	acl:relcl	1
campsite	acl:relcl	1
leak	acl	1
methodology	acl:relcl	1
initial	acl:relcl	1
concern	acl:relcl	1
ena	acl:relcl	1
mangrove	acl:relcl	1
stone	acl:relcl	1
attempt	acl:relcl	1
drug	acl:relcl	1
document	acl:relcl	1
motion	acl:relcl	1
waiver	acl:relcl	1
relationship	acl:relcl	1
complaint	acl	1
fear	acl	1
voice	acl	1
pricing	acl:relcl	1
pedicure	acl:relcl	1
elevator	acl:relcl	1
driver	acl:relcl	1
show	acl:relcl	1
discussion	acl:relcl	1
dilemma	acl:relcl	1
aspiration	acl:relcl	1
view	acl:relcl	1
coffin	acl:relcl	1
investment	acl:relcl	1
flower	acl:relcl	1
lamp	acl:relcl	1
reflector	acl:relcl	1
works	acl:relcl	1
manual	acl:relcl	1
orientation	acl:relcl	1
bind	acl:relcl	1
unit	acl:relcl	1
obstacle	acl:relcl	1
overnight	acl:relcl	1
engine	acl:relcl	1
utility	acl:relcl	1
wording	acl:relcl	1
notice	acl	1
bid	acl:relcl	1
leave	acl:relcl	1
hair	acl:relcl	1
story	acl:relcl	1
vet	acl:relcl	1
boast	acl	1
nudging	acl:relcl	1
person	acl:relcl	1
roar	acl:relcl	1
robe	acl:relcl	1
mixture	acl:relcl	1
fame	acl:relcl	1
certificate	acl:relcl	1
rule	acl:relcl	1
island	acl:relcl	1
shepherd	acl:relcl	1
effect	acl:relcl	1
move	acl:relcl	1
premise	acl	1
epistemology	acl:relcl	1
etiquette	acl	1
engine	acl	1
fascination	acl:relcl	1
chart	acl:relcl	1
ingredient	acl:relcl	1
clay	acl:relcl	1
venue	acl:relcl	1
alliance	acl:relcl	1
death	acl:relcl	1
number	acl	1
viewpoint	acl:relcl	1
skill	acl:relcl	1
perception	acl	1
stranger	acl:relcl	1
expense	acl:relcl	1
marrying	acl:relcl	1
race	acl:relcl	1
dimension	acl:relcl	1
assault	acl:relcl	1
division	acl:relcl	1
role	acl:relcl	1
reflection	acl:relcl	1
headset	acl:relcl	1
ten	acl:relcl	1
sale	acl:relcl	1
argument	acl	1
code	acl:relcl	1
power	acl:relcl	1
header	acl:relcl	1
quote	acl:relcl	1
country	acl	1
cart	acl:relcl	1
delegation	acl:relcl	1
energy	acl	1
desk	acl:relcl	1
shore	acl:relcl	1
water	acl:relcl	1
fiction	acl:relcl	1
light	acl:relcl	1
overcharge	acl:relcl	1
toxin	acl:relcl	1
ball	acl:relcl	1
comfort	acl	1
cater	acl:relcl	1
implant	acl:relcl	1
smile	acl:relcl	1
apprehension	acl	1
understanding	acl	1
tone	acl:relcl	1
spire	acl:relcl	1
event	acl	1
treatment	acl:relcl	1
mongrel	acl:relcl	1
trailer	acl:relcl	1
query	acl:relcl	1
couple	acl:relcl	1
misunderstanding	acl:relcl	1
level	acl:relcl	1
persecution	acl:relcl	1
battle	acl:relcl	1
chicken	acl:relcl	1
design	acl:relcl	1
password	acl:relcl	1
genotype	acl:relcl	1
repair	acl:relcl	1
impact	acl:relcl	1
manikin	acl:relcl	1
industry	acl:relcl	1
price	acl:relcl	1
scar	acl	1
skillsets	acl:relcl	1
gift	acl:relcl	1
landing-spot	acl:relcl	1
picture	acl:relcl	1
airport	acl:relcl	1
perception	acl:relcl	1
ham-stink	acl:relcl	1
indication	acl	1
music	acl:relcl	1
offensive	acl:relcl	1
review	acl:relcl	1
approach	acl:relcl	1
debate	acl:relcl	1
crow	acl	1
e-reader	acl:relcl	1
need	acl:relcl	1
vision	acl:relcl	1
camera	acl:relcl	1
savings	acl:relcl	1
confusion	acl:relcl	1
entity	acl:relcl	1
character	acl	1
attack	acl:relcl	1
purpose	acl:relcl	1
screw	acl:relcl	1
lie	acl:relcl	1
instructor	acl:relcl	1
water	acl	1
translation	acl:relcl	1
folder	acl:relcl	1
trade	acl:relcl	1
university	acl:relcl	1
demon	acl:relcl	1
fish	acl:relcl	1
meeting	acl:relcl	1
mousse	acl:relcl	1
journal	acl:relcl	1
value	acl:relcl	1
format	acl	1
detail	acl:relcl	1
theory	acl:relcl	1
department	acl:relcl	1
delay	acl	1
unity	acl:relcl	1
fence	acl:relcl	1
trotter	acl:relcl	1
ocean	acl:relcl	1
provision	acl:relcl	1
declaration	acl:relcl	1
assumption	acl:relcl	1
consensus	acl	1
block	acl:relcl	1
track	acl:relcl	1
monastery	acl:relcl	1
sheet	acl:relcl	1
tire	acl:relcl	1
emptiness	acl:relcl	1
hamster	acl:relcl	1
ally	acl:relcl	1
regret	acl	1
operator	acl:relcl	1
description	acl:relcl	1
tree	acl:relcl	1
winter	acl	1
formalism	acl:relcl	1
project	acl:relcl	1
guarantee	acl	1
microwave	acl:relcl	1
groove	acl:relcl	1
visa	acl:relcl	1
behavior	acl:relcl	1
course	acl:relcl	1
disaster	acl:relcl	1
strategy	acl:relcl	1
spacecraft	acl:relcl	1
runway	acl:relcl	1
consortium	acl:relcl	1
edition	acl:relcl	1
tale	acl:relcl	1
business	acl:relcl	2
location	acl:relcl	2
society	acl:relcl	2
connection	acl:relcl	2
job	acl:relcl	2
step	acl:relcl	2
pocket	acl:relcl	2
house	acl:relcl	2
meat	acl:relcl	2
proposal	acl:relcl	2
microscope	acl:relcl	2
war	acl:relcl	2
news	acl	2
query	acl	2
page	acl	2
effect	acl	2
city	acl:relcl	2
year	acl:relcl	2
activity	acl:relcl	2
topic	acl:relcl	2
talk	acl	2
site	acl:relcl	2
kid	acl:relcl	2
impression	acl:relcl	2
conclusion	acl	2
snake	acl:relcl	2
result	acl	2
sound	acl:relcl	2
institution	acl:relcl	2
rumor	acl	2
request	acl:relcl	2
position	acl:relcl	2
model	acl:relcl	2
talent	acl:relcl	2
restaurant	acl:relcl	2
land	acl:relcl	2
reminder	acl	2
mountain	acl:relcl	2
technology	acl:relcl	2
info	acl:relcl	2
term	acl:relcl	2
river	acl:relcl	2
technique	acl:relcl	2
old	acl:relcl	2
pretext	acl	2
book	acl:relcl	2
insight	acl:relcl	2
vehicle	acl:relcl	2
email	acl:relcl	2
trauma	acl:relcl	2
choice	acl:relcl	2
structure	acl:relcl	2
fund	acl:relcl	2
commission	acl:relcl	2
use	acl:relcl	2
particle	acl:relcl	2
bird	acl:relcl	2
animal	acl:relcl	2
hope	acl	2
foot	acl:relcl	2
community	acl:relcl	2
test	acl:relcl	2
cat	acl:relcl	2
curve	acl:relcl	2
research	acl:relcl	2
period	acl:relcl	2
bulb	acl:relcl	2
management	acl:relcl	2
license	acl:relcl	2
size	acl:relcl	2
performer	acl:relcl	2
assertion	acl	2
table	acl:relcl	2
hospitality	acl:relcl	2
ground	acl	2
error	acl:relcl	2
wind	acl:relcl	2
toy	acl:relcl	2
growth	acl:relcl	2
act	acl:relcl	2
game	acl:relcl	2
guy	acl:relcl	2
temple	acl:relcl	2
history	acl:relcl	2
suggestion	acl	2
work	acl:relcl	2
form	acl:relcl	2
version	acl:relcl	2
sunlight	acl:relcl	2
list	acl:relcl	2
outcome	acl:relcl	2
critter	acl:relcl	2
notice	acl:relcl	2
terror	acl	2
message	acl	2
genocide	acl:relcl	2
lot	acl:relcl	2
life	acl:relcl	2
agreement	acl:relcl	2
trick	acl:relcl	2
legislation	acl:relcl	2
school	acl:relcl	2
possession	acl:relcl	2
report	acl:relcl	2
bus	acl:relcl	2
friend	acl:relcl	2
prediction	acl	2
proof	acl	2
action	acl:relcl	3
question	acl:relcl	3
kind	acl:relcl	3
government	acl:relcl	3
notion	acl	3
circle	acl:relcl	3
product	acl:relcl	3
box	acl:relcl	3
feeling	acl	3
strain	acl:relcl	3
website	acl:relcl	3
standard	acl:relcl	3
area	acl:relcl	3
swing	acl:relcl	3
belief	acl	3
material	acl:relcl	3
fact	acl:relcl	3
program	acl:relcl	3
anything	acl:relcl	3
concern	acl	3
room	acl:relcl	3
plan	acl:relcl	3
item	acl:relcl	3
environment	acl:relcl	3
evidence	acl	3
talk	acl:relcl	3
letter	acl:relcl	3
food	acl:relcl	3
idea	acl	3
process	acl:relcl	3
nation	acl:relcl	3
dish	acl:relcl	3
tool	acl:relcl	3
economy	acl:relcl	3
impression	acl	3
stuff	acl:relcl	3
study	acl:relcl	3
view	acl	3
principle	acl:relcl	3
sign	acl	4
solution	acl:relcl	4
machine	acl:relcl	4
claim	acl	4
culture	acl:relcl	4
word	acl:relcl	4
measure	acl:relcl	4
statement	acl:relcl	4
mission	acl:relcl	4
place	acl:relcl	4
format	acl:relcl	4
data	acl:relcl	4
sign	acl:relcl	4
field	acl:relcl	4
species	acl:relcl	5
country	acl:relcl	5
something	acl:relcl	5
company	acl:relcl	5
time	acl	5
line	acl:relcl	5
change	acl:relcl	5
file	acl:relcl	5
way	acl	5
name	acl:relcl	5
service	acl:relcl	5
point	acl:relcl	5
part	acl:relcl	6
piece	acl:relcl	6
doubt	acl	6
system	acl:relcl	6
horse	acl:relcl	7
page	acl:relcl	7
day	acl:relcl	7
problem	acl:relcl	7
group	acl:relcl	8
language	acl:relcl	8
people	acl:relcl	8
time	acl:relcl	8
issue	acl:relcl	9
one	acl:relcl	11
percentage	acl:relcl	12
way	acl:relcl	12
thing	acl:relcl	18
fact	acl	38
