In	IN	in
another	DT	another
part	NN	part
of	IN	of
the	DT	the
inn	NN	inn
,	,	,
the	DT	the
gang	NN	gang
convenes	VBZ	convene
to	TO	to
discuss	VB	discuss
why	WRB	why
they	PP	they
get	VBP	get
so	RB	so
little	JJ	little
money	NN	money
for	IN	for
their	PP$	their
efforts	NNS	effort
.	SENT	.
They	PP	they
suspect	VBP	suspect
Jem	NP	Jem
Trehearne	NP	<unknown>
(	(	(
Robert	NP	Robert
Newton	NP	Newton
)	)	)
,	,	,
a	DT	a
gang	NN	gang
member	NN	member
who	WP	who
has	VBZ	have
been	VBN	be
with	IN	with
them	PP	them
